0	6	6	6	0	6	6	6	0	6	6	6	6	6	6	6		
6	6	6	6	6	6	6	6	6	6	6	6	6	6	6	6	
6	1	9	9	9	9	9	13	6	6	6	6	6	6	6	6	
6	4	8	8	8	8	8	12	6	6	6	6	6	6	6	6	
0	4	8	8	8	8	8	12	0	6	6	6	6	6	6	6	
6	15	11	11	11	11	11	14	6	6	6	6	6	6	6	6	
6	6	6	6	6	6	6	6	6	6	6	6	6	6	6	6	
6	6	6	6	6	6	6	6	6	6	6	6	6	6	6	6	
0	6	6	6	0	6	6	6	0	6	6	6	6	6	6	6	
6	6	6	6	6	6	6	6	6	6	6	6	6	6	6	6	
6	6	6	6	6	6	6	6	6	6	6	6	6	6	6	6	
6	6	6	6	6	6	6	6	6	6	6	6	6	6	6	6	
6	6	6	6	6	6	6	6	6	6	6	6	6	6	6	6		
6	6	6	6	6	6	6	6	6	6	6	6	6	6	6	6	
6	6	6	6	6	6	6	6	6	6	6	6	6	6	6	0	
6	6	6	6	6	6	6	6	6	6	6	6	6	6	6	6	